21 21
0 6 15 21 24 24 21 18 12 6 3 0 0 0 0 0 0 0 0 0 0
0 6 12 18 21 21 18 15 9 6 3 0 0 0 0 0 0 0 0 0 0
0 3 9 15 18 15 15 12 9 3 3 0 0 0 0 0 0 0 0 0 0
0 0 6 9 12 12 12 12 6 3 3 0 0 0 0 0 0 0 0 0 0
0 0 0 6 9 12 12 12 9 6 3 3 0 0 0 0 0 0 0 0 0
0 0 0 0 9 12 15 15 12 9 6 6 3 0 0 0 0 0 0 0 0
0 0 0 0 9 15 18 18 15 12 9 9 6 3 0 0 0 0 0 0 0
0 0 0 0 9 15 18 18 15 12 9 9 9 6 3 0 0 0 0 0 0
0 0 0 0 9 15 18 18 15 12 9 6 6 6 6 3 3 3 0 0 0
0 0 0 3 9 12 15 12 9 6 6 3 6 6 6 6 6 6 6 3 0
0 0 0 0 6 9 9 6 6 3 3 3 3 3 3 3 6 6 6 3 0
0 0 0 0 3 3 3 0 0 0 0 0 0 0 0 0 3 3 6 6 3
0 0 3 3 3 0 0 0 0 0 0 0 0 0 0 0 0 0 3 6 6
6 9 9 9 6 3 0 0 0 0 0 0 0 0 0 0 0 0 0 3 6
15 18 18 15 12 9 6 3 0 0 0 0 0 0 0 0 0 0 0 3 3
21 24 24 24 21 15 12 9 6 3 3 0 0 0 0 0 0 0 0 0 3
24 27 27 27 24 21 18 15 12 9 3 0 0 0 0 0 0 0 0 0 0
24 24 24 24 24 21 21 18 12 9 3 0 0 0 0 0 0 0 0 0 0
18 18 18 18 18 21 18 18 12 6 0 0 0 0 0 0 0 0 0 0 0
12 9 9 9 12 15 18 15 12 6 0 0 0 0 0 0 0 0 0 0 0
3 0 0 3 9 12 15 12 9 3 0 0 0 0 0 0 0 0 0 0 0
