51 51
100 60 80 120 160 140 60 0 0 0 0 40 200 440 580 520 300 100 0 0 0 0 0 160 380 600 620 420 160 0 0 0 0 80 100 40 0 0 0 40 120 240 420 500 380 160 0 0 0 0 0
180 140 120 120 100 60 0 0 0 0 0 180 340 540 660 560 340 120 0 0 0 0 160 340 560 700 640 380 120 0 0 0 80 240 240 180 60 0 0 0 0 140 340 420 340 140 0 0 0 0 0
300 220 140 60 0 0 0 0 0 0 20 200 340 520 600 540 360 220 80 0 0 100 300 460 600 660 540 280 60 0 0 60 300 460 440 360 180 0 0 0 0 0 80 180 140 0 0 0 0 0 0
360 240 100 0 0 0 0 0 0 0 0 120 240 360 440 420 340 300 260 180 140 180 280 400 480 480 340 140 20 0 60 260 500 600 540 420 240 40 0 0 0 0 0 0 0 0 0 0 0 0 0
300 160 20 0 0 0 0 0 0 0 0 20 100 180 220 220 240 280 320 300 220 160 160 240 280 240 140 40 20 40 180 400 540 540 440 320 200 80 0 0 0 0 0 0 0 0 0 0 0 0 0
160 40 0 0 0 0 40 40 0 0 0 0 80 120 100 60 100 180 260 260 180 100 80 120 140 100 40 20 40 120 260 400 440 360 220 120 80 100 100 40 0 0 0 0 0 0 0 0 0 0 20
60 0 0 0 0 100 140 140 80 40 40 100 160 160 80 0 0 40 140 160 120 80 60 120 140 100 60 40 80 160 260 340 300 160 20 0 0 100 220 220 100 0 0 0 60 140 180 140 60 0 20
20 0 0 0 120 240 280 260 200 140 120 160 220 180 60 0 0 0 40 100 100 100 100 140 160 140 80 60 80 140 200 200 120 0 0 0 0 120 320 360 260 140 80 100 200 280 300 260 160 60 40
100 0 0 140 340 440 400 340 240 180 140 140 160 100 0 0 0 0 20 100 140 160 160 180 180 180 140 100 60 60 40 0 0 0 0 0 0 140 360 420 340 240 180 160 220 280 300 280 220 160 140
200 60 80 260 460 500 400 300 200 140 120 80 40 0 0 0 20 40 80 140 200 240 220 200 180 200 180 140 40 0 0 0 0 0 0 0 0 180 320 340 280 220 160 120 140 160 180 200 220 220 220
240 80 100 260 420 420 260 120 60 80 100 60 0 0 0 40 120 120 120 180 240 240 220 160 140 200 220 180 60 0 0 0 0 0 0 40 120 200 220 200 160 120 80 40 40 60 80 120 180 220 240
140 0 0 140 280 260 80 0 0 40 140 100 0 0 0 40 100 120 100 140 200 200 160 100 80 180 260 240 120 0 0 0 0 0 80 140 200 220 180 120 80 60 40 40 40 60 80 100 160 180 160
0 0 0 0 140 100 0 0 0 60 200 200 80 0 0 0 40 40 20 60 120 120 80 0 20 140 280 300 180 20 0 0 0 20 100 160 220 200 140 80 60 40 60 80 120 140 160 160 140 120 60
0 0 0 0 60 60 0 0 20 220 340 340 240 100 0 0 0 0 0 0 0 0 0 0 0 0 180 260 200 60 0 0 0 20 80 140 140 100 20 0 0 0 80 160 220 240 240 180 100 0 0
20 0 0 20 80 120 140 200 320 440 480 440 340 200 0 0 0 0 0 0 0 0 0 0 0 0 0 120 120 60 0 0 0 0 40 40 0 0 0 0 0 0 140 260 320 300 260 160 20 0 0
120 200 180 100 80 160 320 480 600 600 500 400 340 200 0 0 0 0 0 0 0 0 0 0 0 0 0 0 40 40 40 20 0 0 0 0 0 0 0 0 0 40 240 360 360 280 200 80 0 0 0
160 300 240 100 0 100 340 580 680 580 380 260 220 100 0 0 0 0 40 120 140 60 0 0 0 0 0 0 20 60 100 120 80 40 20 0 0 0 0 0 0 180 340 400 320 200 100 0 0 0 0
100 240 160 0 0 0 180 420 540 440 240 100 60 0 0 0 20 100 180 280 320 260 140 60 0 0 0 0 80 120 180 180 160 120 100 60 0 0 0 0 140 300 440 420 280 120 20 0 0 20 80
0 100 20 0 0 0 0 240 360 260 60 0 0 0 0 0 120 200 280 400 440 400 320 220 120 40 20 80 160 220 260 260 220 180 180 140 80 20 60 160 300 440 520 440 260 100 0 0 0 80 180
0 0 0 0 0 0 0 140 200 100 0 0 0 0 0 40 180 240 280 360 400 380 300 240 160 100 120 200 260 300 320 280 240 240 260 300 280 280 300 360 460 580 620 520 340 160 20 0 0 20 140
0 0 0 0 0 0 80 140 140 20 0 0 0 0 0 40 160 180 180 200 200 200 160 100 60 80 160 260 320 340 280 200 160 200 300 400 480 500 480 460 500 560 620 580 440 240 80 0 0 0 0
0 0 60 160 180 180 180 180 140 40 0 0 0 0 0 60 120 80 40 20 20 20 0 0 0 20 120 220 260 260 160 40 0 80 240 420 560 580 500 400 360 400 500 560 480 300 80 0 0 0 0
0 100 200 280 260 200 160 140 120 120 80 20 0 0 40 100 120 60 0 0 0 0 0 0 0 0 60 140 160 140 20 0 0 0 140 360 520 520 380 240 180 200 340 440 420 240 20 0 0 0 0
140 220 300 260 180 80 20 20 80 140 180 140 100 80 120 180 180 120 40 20 60 120 160 140 100 80 60 60 60 40 0 0 0 0 60 280 420 420 260 100 40 60 200 320 280 120 0 0 0 0 0
220 300 320 260 100 0 0 0 0 120 220 200 160 160 200 260 260 220 160 120 140 200 220 220 200 120 60 20 20 20 0 0 0 0 40 220 360 340 200 60 0 20 140 240 200 40 0 0 0 0 40
200 260 280 240 120 0 0 0 0 40 140 160 120 140 220 300 340 320 280 200 140 120 140 160 180 140 80 60 80 120 80 0 0 0 80 200 300 320 260 140 80 100 180 240 200 40 0 0 0 0 0
100 120 220 260 220 120 0 0 0 0 40 60 60 80 160 260 340 360 340 220 40 0 0 40 120 120 100 100 160 240 300 280 220 160 140 160 240 300 320 280 220 220 260 300 240 100 0 0 0 0 0
20 40 160 280 320 220 80 0 0 0 0 0 20 20 60 140 220 280 280 140 0 0 0 0 100 120 100 100 180 300 400 460 380 260 160 120 140 240 300 320 260 240 300 340 300 180 20 0 0 0 0
60 80 180 300 320 220 60 0 0 0 0 60 60 40 20 40 80 140 160 60 0 0 0 80 180 160 80 40 100 220 360 440 380 240 120 40 40 100 180 180 140 120 200 280 260 160 20 0 0 0 0
160 160 240 300 260 140 0 0 0 0 80 140 140 100 0 0 0 0 20 0 0 0 120 260 320 240 60 0 0 80 240 320 280 160 40 0 0 0 20 0 0 0 60 160 180 80 0 0 0 40 200
220 220 220 180 100 0 0 0 0 0 120 160 120 20 0 0 0 0 0 0 40 200 340 460 480 320 60 0 0 0 80 180 180 120 40 0 0 0 0 0 0 0 0 20 40 0 0 0 0 120 320
220 180 100 0 0 0 0 0 0 60 120 80 0 0 0 0 0 0 0 0 160 380 520 560 520 340 100 0 0 0 0 20 80 120 120 140 180 180 120 0 0 0 0 0 0 0 0 0 0 60 300
160 100 0 0 0 0 0 0 140 220 160 20 0 0 0 0 0 0 0 0 240 440 500 460 400 280 140 20 0 0 0 0 0 100 200 300 400 420 320 160 40 0 0 0 0 0 0 0 0 0 140
100 20 0 0 0 0 0 180 360 400 260 40 0 0 0 0 0 0 0 120 280 360 340 240 180 140 140 120 80 0 0 0 0 40 200 340 500 540 420 240 100 20 40 80 60 0 0 0 0 0 0
100 20 0 0 0 0 140 340 520 540 380 160 0 0 0 0 20 100 140 240 280 260 160 60 0 20 100 160 120 20 0 0 0 0 100 240 420 460 360 180 40 0 40 160 200 140 0 0 0 0 0
80 20 0 0 0 120 260 440 620 640 500 300 120 0 0 60 200 280 300 340 280 160 0 0 0 0 40 140 120 20 0 0 0 0 20 160 300 340 220 60 0 0 20 220 360 300 160 0 0 0 0
20 0 0 0 120 220 280 380 500 540 480 380 280 200 180 260 340 380 400 400 280 100 0 0 0 0 0 80 80 0 0 0 0 0 80 160 200 160 20 0 0 0 0 280 460 440 320 120 0 0 0
0 0 0 120 200 240 200 160 180 220 280 340 360 380 400 380 380 360 380 380 300 140 0 0 0 0 0 20 60 0 0 80 180 240 240 200 100 0 0 0 0 0 0 280 460 460 360 160 0 0 0
0 0 60 200 260 200 80 0 0 0 20 200 340 460 480 400 280 240 240 300 320 240 80 0 0 0 0 20 40 0 80 240 380 400 300 180 0 0 0 0 0 0 40 220 340 320 260 80 0 0 0
20 40 160 280 300 180 20 0 0 0 0 60 260 420 460 340 180 120 120 240 340 340 200 0 0 0 0 40 80 40 120 280 380 360 220 40 0 0 0 0 0 40 120 180 200 180 120 0 0 0 0
120 140 260 360 340 220 40 0 0 0 0 0 220 380 420 320 160 80 100 220 360 360 240 40 0 0 0 80 120 80 140 220 260 180 20 0 0 0 0 120 140 180 200 180 120 80 40 0 0 0 0
160 180 280 380 380 260 100 0 0 0 0 0 180 340 400 300 160 80 60 180 320 360 260 60 0 0 0 140 200 160 160 140 80 0 0 0 0 0 160 320 340 340 280 200 100 40 20 0 0 20 180
80 100 180 300 340 300 180 20 0 0 0 20 160 320 400 340 200 80 20 100 220 300 240 100 0 0 40 180 260 260 200 80 0 0 0 0 0 140 400 520 500 460 340 240 160 120 100 60 60 160 320
0 0 40 160 240 260 220 140 40 0 20 80 160 300 400 400 260 100 0 0 100 200 220 100 0 0 20 160 260 300 220 20 0 0 0 0 120 400 580 580 500 400 280 220 200 200 200 160 140 180 300
0 0 0 40 120 180 200 180 160 120 100 120 140 280 420 420 300 100 0 0 0 120 160 80 0 0 0 60 180 260 200 20 0 0 0 120 380 580 580 460 320 200 100 100 160 220 240 180 100 80 160
40 20 0 20 60 100 120 140 140 120 100 100 120 240 400 420 300 100 0 0 0 60 140 60 0 0 0 0 80 180 140 0 0 0 60 280 500 580 460 260 100 0 0 0 60 120 140 100 0 0 0
200 160 100 40 20 40 60 80 80 80 60 60 80 200 340 380 280 80 0 0 0 60 120 60 0 0 0 0 0 80 80 0 0 0 140 340 500 500 300 80 0 0 0 0 0 0 0 0 0 0 0
300 260 180 100 40 40 40 60 60 40 0 0 0 20 140 180 120 0 0 0 0 140 200 160 60 0 0 0 0 0 0 0 0 20 160 320 440 360 120 0 0 0 0 0 0 0 0 0 0 0 0
320 240 160 120 120 120 100 100 100 60 0 0 0 0 0 0 0 0 0 0 100 260 320 320 240 40 0 0 0 0 0 0 0 40 140 240 300 220 0 0 0 0 0 0 0 0 0 0 0 0 0
220 120 80 100 160 180 140 140 160 160 80 0 0 0 0 0 0 0 0 100 220 300 340 380 340 180 0 0 0 0 0 0 20 60 100 140 160 140 20 0 0 0 0 0 0 0 0 0 0 0 0
120 0 0 60 160 200 140 140 200 260 200 40 0 0 0 0 0 0 120 240 280 260 240 300 300 240 100 0 0 0 0 60 80 80 60 60 120 140 120 40 0 0 0 40 40 0 0 0 0 0 60
