51 51
12 9 9 9 9 9 9 9 9 12 12 12 12 12 12 12 12 12 9 9 6 6 6 6 6 6 6 6 6 6 6 9 9 9 12 12 12 12 12 12 12 12 12 15 15 12 12 12 12 9 9
9 9 9 9 9 9 9 9 9 9 12 12 12 12 12 12 12 9 9 9 6 6 6 6 6 6 6 6 6 6 6 9 9 9 12 12 12 12 12 12 12 12 12 15 12 12 12 12 9 9 9
9 9 9 9 9 9 9 9 9 9 12 12 12 12 12 12 9 9 9 6 6 6 6 3 3 6 6 6 6 6 9 9 9 12 12 12 15 15 15 15 15 15 15 15 12 12 12 12 9 9 9
9 9 9 9 9 9 9 9 9 9 9 9 12 12 9 9 9 9 9 6 6 6 6 6 3 6 6 6 6 9 9 9 12 12 15 15 15 15 15 15 15 15 15 15 12 12 12 12 9 9 9
9 9 9 9 9 9 9 9 9 9 9 9 9 9 9 9 9 9 9 6 6 6 6 6 6 6 6 6 6 9 9 12 12 15 15 15 15 15 15 15 15 15 15 15 15 12 12 9 9 9 9
9 9 9 9 9 9 9 9 9 9 9 9 9 9 9 9 9 9 9 9 9 9 6 6 6 6 6 6 9 9 12 12 15 15 15 15 15 15 18 18 15 15 15 15 15 12 12 9 9 9 9
9 9 9 9 9 9 9 9 9 9 9 9 9 9 9 9 9 9 9 9 9 9 9 9 9 9 9 9 9 9 12 12 15 15 15 15 15 18 18 18 18 15 15 15 15 12 12 9 9 9 9
9 9 9 9 9 9 9 9 9 9 9 9 9 9 9 9 9 9 9 12 12 12 12 9 9 9 9 9 9 12 12 12 15 15 15 15 15 15 18 18 18 18 15 15 12 12 12 9 9 9 9
9 9 9 9 9 9 9 9 9 9 9 9 9 9 9 9 9 12 12 12 12 12 12 12 12 9 9 9 12 12 12 12 15 15 15 15 15 15 15 18 18 15 15 15 12 12 12 9 9 9 9
9 9 9 12 12 12 9 9 9 9 9 9 9 9 9 9 12 12 12 12 12 15 12 12 12 12 12 12 12 12 12 12 15 15 15 15 15 15 15 15 15 15 15 12 12 12 12 9 9 9 9
12 12 12 12 12 12 9 9 9 9 9 9 9 9 9 9 12 12 12 15 15 15 15 12 12 12 12 12 12 12 12 12 12 12 15 15 15 15 15 15 15 15 15 12 12 12 9 9 9 12 12
12 12 12 12 12 9 9 9 9 9 9 9 9 9 9 9 12 12 12 15 15 15 15 15 12 12 12 12 12 12 12 12 12 12 12 15 15 15 15 15 15 15 12 12 12 12 12 12 12 12 12
9 9 9 9 9 9 9 9 9 9 9 9 9 9 9 9 12 12 12 15 15 15 15 12 12 12 12 12 12 12 12 12 12 12 12 15 15 15 15 15 15 15 12 12 12 12 12 12 12 12 12
9 9 9 9 9 9 9 9 9 9 9 9 9 9 9 9 12 12 12 15 15 15 15 12 12 12 12 12 12 12 12 12 12 12 12 15 15 15 15 15 15 12 12 12 12 12 12 12 12 12 12
9 9 9 9 9 9 9 9 9 9 9 9 9 9 9 9 9 12 12 12 15 15 12 12 12 12 12 12 12 12 12 12 12 12 12 15 15 15 15 15 12 12 12 12 12 12 12 12 12 12 12
9 9 9 9 9 9 6 9 9 9 9 9 9 9 9 9 9 12 12 12 12 12 12 12 12 12 12 12 9 9 9 9 12 12 12 12 15 15 15 12 12 12 12 12 12 12 12 12 12 12 12
9 9 9 9 9 6 6 6 6 9 9 9 9 9 9 9 9 12 12 12 12 12 12 12 12 12 12 12 9 9 9 9 9 12 12 12 12 12 12 12 12 12 12 12 12 12 12 12 12 12 12
12 9 9 9 9 6 6 6 6 9 9 9 9 9 9 9 9 12 12 12 12 12 12 12 12 12 12 12 9 9 9 9 9 9 12 12 12 12 12 12 12 12 12 12 12 12 12 12 9 9 9
12 9 9 9 9 6 6 6 6 6 9 9 9 9 9 9 9 9 12 12 12 12 12 12 12 12 12 12 9 9 9 9 9 9 9 9 12 12 12 12 12 12 12 12 12 12 12 9 9 9 9
12 9 9 9 9 9 9 9 9 9 9 9 9 9 9 9 9 9 12 12 12 12 12 12 12 12 12 12 9 9 9 6 6 9 9 9 9 9 9 9 9 9 9 9 9 9 9 9 9 9 9
12 9 9 9 9 9 9 9 9 9 9 9 9 9 9 9 9 9 12 12 12 12 12 12 12 12 12 12 9 9 9 6 6 6 9 9 9 9 9 9 9 9 9 9 9 9 9 9 9 9 9
9 9 9 9 9 9 9 9 9 9 9 9 9 9 9 9 9 9 12 12 12 12 12 12 12 12 12 9 9 9 9 6 6 6 9 9 9 9 9 9 9 9 9 9 9 9 9 9 9 9 9
9 9 9 9 9 9 9 9 9 9 6 6 9 9 9 9 9 9 9 9 9 9 9 9 9 9 9 9 9 9 9 9 6 9 9 9 9 9 9 9 9 9 9 12 12 12 9 9 9 9 9
9 9 9 9 9 9 9 9 9 6 6 6 6 6 9 9 9 9 9 9 9 9 9 9 9 9 9 9 9 9 9 9 9 9 9 9 9 9 9 9 9 9 12 12 12 12 9 9 9 9 9
9 9 9 9 9 9 9 9 9 6 6 6 6 6 6 6 6 9 9 6 6 6 6 9 9 9 9 9 9 9 9 9 9 9 9 9 9 9 9 9 9 9 12 12 12 12 12 9 9 9 9
9 9 12 12 9 9 9 9 9 6 6 6 6 6 6 6 6 6 6 6 6 6 6 6 9 9 9 9 9 9 9 9 9 9 9 9 9 9 9 9 9 12 12 12 12 12 12 9 9 9 9
12 12 12 12 12 9 9 9 9 6 6 6 6 6 6 6 6 6 6 6 6 6 6 6 9 9 9 9 9 9 9 9 9 9 9 9 9 9 9 9 9 12 12 12 12 12 12 9 9 9 9
12 12 12 12 12 12 9 9 9 6 6 6 6 6 6 6 6 6 6 6 6 6 6 6 9 9 9 9 9 9 9 9 9 9 9 9 9 9 9 9 9 12 12 12 12 12 12 9 9 9 9
12 12 12 12 12 12 9 9 9 6 6 6 6 6 6 6 6 6 6 6 6 6 6 9 9 9 9 9 9 9 9 9 9 9 9 9 9 9 9 9 9 12 12 12 12 12 9 9 9 9 9
12 12 12 12 12 12 9 9 9 9 6 6 6 6 6 6 6 6 6 6 6 6 9 9 9 9 9 12 12 12 9 9 9 9 9 9 12 12 12 12 12 12 12 12 12 9 9 9 9 9 9
12 12 15 12 12 12 12 9 9 9 9 9 9 9 9 9 9 9 9 9 9 9 9 9 9 12 12 12 12 12 12 12 12 12 12 12 12 12 12 12 12 12 12 12 12 9 9 9 9 9 9
12 12 15 15 12 12 12 9 9 9 9 9 9 9 9 9 9 9 9 9 9 9 9 9 12 12 12 12 12 12 12 12 12 12 12 12 12 12 12 12 12 12 12 12 12 9 9 9 9 9 9
12 12 12 12 12 12 12 12 12 9 9 9 9 9 9 9 9 9 9 9 9 9 9 12 12 12 12 12 12 12 12 12 12 12 12 12 12 12 12 12 12 12 12 12 12 9 9 9 9 9 9
12 12 12 12 12 12 12 12 12 12 12 12 12 12 9 9 9 9 12 12 9 9 9 12 12 12 12 12 12 12 12 12 12 12 12 12 12 12 12 12 12 12 12 12 12 12 9 9 9 9 9
12 12 12 12 12 12 12 12 12 12 12 12 12 12 12 9 9 12 12 12 9 9 9 9 12 12 12 12 12 12 12 12 12 12 12 12 12 12 12 12 12 12 12 12 12 12 12 9 9 9 12
9 12 12 12 12 12 12 12 12 12 12 12 12 12 12 9 9 9 12 12 9 9 9 9 9 9 9 9 9 9 9 9 9 9 9 9 9 12 12 12 12 15 12 12 12 12 12 12 12 12 12
9 9 12 12 12 12 12 12 12 12 12 12 12 12 12 9 9 9 12 12 9 9 9 9 9 9 9 9 9 9 9 9 9 9 9 9 9 9 12 12 12 15 15 12 12 12 12 12 12 12 12
9 9 9 12 12 12 12 12 12 12 12 12 12 12 12 9 9 9 12 12 12 12 9 9 9 9 9 9 9 9 9 9 9 9 9 9 9 9 12 12 12 15 15 12 12 12 12 12 12 12 12
9 9 9 9 12 12 12 12 12 12 12 12 12 12 9 9 9 12 12 12 12 12 12 9 9 9 9 9 6 6 9 9 9 9 9 9 9 9 9 12 12 12 12 12 12 12 12 12 12 12 12
9 9 9 9 9 9 12 12 12 12 12 12 12 12 9 9 9 12 12 12 12 12 12 12 9 9 9 6 6 6 6 6 9 9 6 6 6 9 9 9 12 12 12 12 12 12 12 12 12 12 12
9 9 9 9 9 9 9 12 12 12 12 12 12 12 9 9 12 12 12 12 15 15 12 12 12 9 9 6 6 6 6 6 9 9 9 6 6 9 9 9 9 12 12 12 12 12 12 12 12 12 12
9 9 9 9 9 9 9 9 12 12 12 12 12 12 9 9 12 12 12 15 15 15 15 12 12 9 9 9 6 6 6 9 9 9 9 9 6 6 9 9 9 12 12 12 12 12 12 12 12 12 12
9 9 9 9 9 9 9 9 9 12 12 12 12 9 9 12 12 12 12 15 15 15 15 15 12 12 9 9 9 9 9 9 9 9 9 9 9 9 9 9 9 9 12 12 12 12 12 12 12 12 12
9 9 9 9 9 9 9 9 9 9 9 9 9 9 9 9 12 12 12 15 15 15 15 15 12 12 9 9 9 9 9 9 9 9 9 9 9 9 9 9 9 9 12 12 12 12 12 12 12 12 12
9 9 9 9 9 9 9 9 9 9 9 9 9 9 9 9 12 12 12 15 15 15 15 15 12 12 12 9 9 9 9 9 9 9 9 9 9 9 9 9 9 9 12 12 12 12 12 12 12 12 12
9 9 9 9 9 9 6 9 9 9 9 9 9 9 9 9 12 12 12 15 15 15 15 15 15 12 12 12 9 9 9 12 12 12 12 9 9 9 9 9 9 9 12 12 12 12 12 12 12 12 12
9 9 9 9 9 9 6 6 6 6 9 9 9 9 9 9 9 12 12 12 15 15 15 15 15 12 12 12 12 12 12 12 12 12 12 12 12 9 9 9 9 12 12 12 12 12 12 12 12 12 12
12 9 9 9 9 9 9 6 6 6 6 6 6 9 9 9 9 12 12 12 15 15 15 15 12 12 12 12 12 12 12 12 12 12 12 12 12 12 12 12 12 12 12 12 12 12 12 12 12 12 12
12 12 9 9 9 9 9 9 9 9 9 6 6 6 9 9 9 12 12 12 12 12 12 12 12 12 12 12 12 12 12 12 12 12 12 12 12 12 12 12 12 12 12 12 12 12 12 12 12 12 12
12 12 9 9 9 9 9 9 9 9 9 9 9 6 9 9 9 9 12 12 12 12 12 12 12 12 12 12 12 12 12 12 12 12 12 12 12 12 12 12 12 12 12 12 12 12 12 12 12 12 12
12 12 9 9 9 9 9 9 9 9 9 9 9 9 9 9 9 9 12 12 12 12 12 12 12 12 12 12 12 12 12 12 12 12 12 12 12 12 12 12 12 12 12 12 12 9 9 9 9 12 12
