21 21
50 40 40 40 50 50 50 40 40 50 50 50 40 40 40 40 40 40 40 40 40
50 40 40 40 40 50 50 40 40 50 50 50 50 50 50 50 40 40 40 40 40
50 40 40 40 40 40 40 40 40 50 50 50 50 50 50 50 40 40 40 50 50
40 40 40 40 40 30 40 40 40 40 40 40 40 40 40 40 40 40 40 50 60
30 30 30 40 40 40 40 40 40 40 40 40 40 30 40 40 40 40 40 50 50
20 20 30 40 40 40 40 40 40 30 30 30 30 30 30 40 40 40 40 40 50
20 20 20 30 40 40 40 40 40 40 30 30 30 20 20 30 30 30 30 40 40
20 20 20 30 30 30 40 40 40 40 40 30 30 20 20 20 30 30 30 30 40
30 30 30 30 40 40 40 50 40 40 40 40 30 20 20 20 20 20 30 30 40
40 40 40 40 50 50 50 50 40 40 40 40 40 30 20 20 20 20 30 30 40
50 50 50 50 60 60 60 50 50 50 50 50 40 30 20 20 20 20 30 40 50
50 50 50 60 60 60 60 60 60 50 50 50 40 30 20 20 20 20 30 40 50
50 50 50 50 60 60 60 60 60 60 60 50 40 40 30 20 20 30 40 50 50
50 60 60 50 60 60 60 60 60 60 60 60 50 50 40 30 30 40 50 50 50
60 60 50 50 50 60 60 60 60 60 70 70 70 60 50 40 40 50 50 60 60
50 50 50 50 50 50 60 70 70 70 70 70 70 70 60 50 50 50 60 60 60
50 40 50 50 50 50 60 70 70 70 70 70 70 60 60 50 50 50 60 60 60
40 40 40 50 50 50 50 60 60 60 60 60 60 60 60 50 50 50 60 60 60
40 40 40 50 50 50 50 50 50 50 50 50 50 50 50 50 50 50 50 60 50
40 40 40 50 50 50 50 50 50 50 50 50 50 50 50 50 50 50 50 50 50
40 40 40 40 50 50 50 50 40 50 50 50 50 50 50 50 50 50 50 50 50
